20,20,
9,9,
1,0,0,0,0,0,0,0,0,0,0,0,0,0,0,0,0,0,0,0,
0,1,0,0,0,0,0,0,0,0,0,0,0,0,0,0,0,0,0,0,
0,0,1,0,0,0,0,0,0,0,0,0,0,0,0,0,0,0,0,0,
0,0,0,1,0,0,0,0,0,0,0,0,0,0,0,0,0,0,0,0,
0,0,0,0,1,0,0,0,0,0,0,0,0,0,0,0,0,0,0,0,
0,0,0,0,0,0,0,0,0,0,0,0,0,0,0,0,0,0,0,0,
0,0,0,0,0,1,1,1,1,1,1,1,1,3,1,0,0,0,0,0,
0,0,0,0,0,1,1,2,1,1,1,1,3,1,1,0,0,0,0,0,
0,0,0,0,0,1,1,1,2,1,1,3,1,1,1,0,0,0,0,0,
0,0,0,0,0,1,1,1,1,2,3,1,1,1,1,0,0,0,0,0,
0,0,0,0,0,1,1,1,1,3,2,1,1,1,1,0,0,0,0,0,
0,0,0,0,0,1,1,1,3,1,1,2,1,1,1,1,0,0,0,0,
0,0,0,0,0,1,1,3,1,1,1,1,2,1,1,0,0,0,0,0,
0,0,0,0,0,1,3,1,1,1,1,1,1,2,1,0,0,0,0,0,
0,0,0,0,0,1,1,1,1,1,1,1,1,1,1,0,0,0,0,0,
0,0,0,0,0,0,0,0,0,0,0,0,0,0,0,0,0,0,0,0,
0,0,0,0,0,0,0,0,0,0,0,0,0,0,0,0,0,0,0,0,
0,0,0,0,0,0,0,0,0,0,0,0,0,0,0,0,0,0,0,0,
0,0,0,0,0,0,0,0,0,0,0,0,0,0,0,0,0,0,0,0,
0,0,0,0,0,0,0,0,0,0,0,0,0,0,0,0,0,0,0,0,
